1111111111111111111111111111111111
10P00000000C000000CC00000000000001
1000100000111111101111101111111001
1000100C00100000001000000001000001
1000100C00111111101111100C01000001
10001000001000C0001000000001000001
100011111C111111101111100001000001
100000C0000C0000000000000E000000E1
1111111111111111111111111111111111